NO ./img/item_0.xpm
SO ./img/item_1.xpm
WE ./img/item_2.xpm
EA ./img/item_3.xpm

F 220,100,0
C 225,30,0

        11111
        10001
        10111
        1001111111111111111111111111
111111111011000001110000000000000001
100000000011000001110111111111111111
11111111111111111111111111111111111111111111111111
       101
11111111111111111111111111111111111111111111111111
11110111111111011100000010001
1111011111 111011101010010001
11000000111101011100000010001
10000000000000001100000010001
10000000000000001101010010001
11000001110101011111011110N0111
11110111 1110101 101111010001
11111111 1111111 111111111111
