11111111111111111111111111
1eC10000000C100C10000e00C1
10000111110000e000111110e1
1P0011E0000C100C10000000C1
11111111111111111111111111
